početak - der Beginn
klub - der Club
publika, javnost - das Publikum
šetnja - der Spaziergang
prezentacija, predstavljanje - die Vorstellung
otvoren - eröffnen
otvorio je - hat eröffnet
produziti, prositiri - verlängern
produzio je, prosirio je - hat verlängert
propustiti, zakasniti - verpassen
propustio je, zakasnio je - hat verpasst
popularan, voljen - beliebt
klasično - klassisch
besplatno - kostnelos
kulturno - kulturell
isplatljivo, vredno toga - lohnen sich
vredelo je, isplatilo se - hat sich-gelohnt
isprobati - probieren
probao je nesto - hat etwas-probiert
biti u pravu - recht haben
bio je u pravu - hat recht-gehabt
uraditi nešto - unternehmen
uradio nešto - hat etwas-unternommen
pokušati - versuchen
pokušati nešto - hat etwas-versucht
odlaziti, napustiti - weggehen
je otišao - ist weggegangen
negativan - negativ
biti radoznao - neugierig sein
pozitivan - positiv
biti istinit - wahr sein
aha dobro - na ja
it's ok - schon gut
bezsmisleno, glupost - der Unsinn
ljubav - die Liebe
glasati - abstimmen
imenovati, nazvati nekoga po imenu - nennen