svetlo - das Licht
more - das Meer
reka - der Fluss
država (L) - der Land
država (S) - der Staat
luka - der Hafen
planina - der Berg
kuće - die Häuser
magla - der Nebel
svuda - überall
reklame - die Werbung
opuštanje - die Entspannung
doživeti - erleben
farma - der Bauernhof
uživati - genießen
ponuda - das Angebot
iskustvo - die Erfahrung
pored toga - außerdem
prijaviti se - sich anmelden
javiti se - sich Melden
vetar - der Wind
početnik - der Anfänger
napredni (čovek) - der Fortgeschrittene
napor - die Anstrengung
posavetovati - beraten
oprema - die Ausrüstung
komarac - die Mücke
nudi - bietet
ponašati se - sich benehmen
znojiti se - schwitzen
iskreno - ehrlich
povezati - verbinden
izgubiti - verlieren
lopov - der Dieb
lopovi - die Diebe
krađa - der Diebstahl
peh - das Pech
