pregled - die Untersuchung
uspeh - der Erfolg
privreda - die Wirtschaft
briga - die Sorge
istina - die Wahrheit
verovati nekome - vertauen jemanden
povreda - die Verletzung
rečenica - der Satz
uslov - NISTA
tim - das Team
preporučiti - empfehlen
šolja - die Tasse 
kašika - der Löffel
viljuška - die Gabel
zajedno plaćati - zusammen zahlen
odvojeno plaćati - getrent zahlen
so - der Salz
makar, barem (m) - mindestens
već - NISTA
popust - die Ermäßigung
ulaznica - die Eintrittskarte
kostim - das Kostüm
umetnost - die Kunst 
smeštaj - die Unterkunft
crkva - die Kirche
katedrala - der Dom
beli luk - der Knoblauch
tržni centar - das Einkaufszentrum
država - das Land
grad - die Stadt
selo - das Dorf
mesto - der Ort
izložba - die Ausstellung
upoznati - kennenlernen
sigurno - sicher