zadatak - die Aufgabe
razred - die Klasse
vest - die Nachricht
semestar - das Semester
škola jezika - die Sprachenschule
test - der Test
dečko, momak, tip - der Typ
tip učenja - der Lernertyp
komunalni koledž - die Volkshochschule
gledati - anschauen
gledao je - hat angeschaut
zapisati - aufschreiben
zapisao je - hat aufgeschrieben
ispravljati - korrigieren
ispravljao je - hat korrigiert
rešiti - lösen
rešio je - hat gelösen
zapamtiti - merken
primetio je - hat sich-gemerkt
prevesti - übersetzen
je preveo - hat übersetzt
ponoviti - wiederholen
ponovio je - hat wiederholt
sadašnjost - die Gegenwart
prošlost - die Vergangenheit
planirati - planen
planirao je - hat geplant
zaljubiti se - verlieben sich
putovati - verreisen
odputovao je - hat verreist
moguće - möglich
sve - aller 
najvažniji - am allerwichtigsten
kao - als