DVD - die DVD
televizor - das Fernsehen
<<<<<<< HEAD
epizoda / posledica - die Folge
kriminal - der Krimi
program - das Programm
prijemnik - der Rundfunk
=======
epizoda, posledica - die Folge
kriminal - der Krimi
program - das Programm
prijemnik - der Rundfunk
tv program - der Sender
privatni tv program - der Privatsender
emisija - die Sendung
serija - die Serie
igrani film - der Spielfilm
video - das Video
gledalac - der Zuschauer
gledati - gucken
gledao je - hat geguckt
proizvoditi - produzieren
proizveo je - hat produziert
javno - öffentlich
privatno - privat
odelo - der Anzug
red vožnje - der Fahrplan
restoran (G) - die Gaststätte
okolina - die Gegend
dečija kolica - der Kinderwagen
parfem - das Parfüm
ruža - die Rose
lonac - der Topf
značiti - bedeuten
značilo - hat bedeutet
sopstveni - eigen
čvrsto - fest
navika - die Gewohnheit  
knap - knapp
socialan - sozial
osim - außer
u međuvremenu - inzwischen
>>>>>>> 1253d967e15803cff09f0c82c78e517deeaca6cd
